NO ./utils/sprite/map/floor_map.xpm
SO ./utils/sprite/map/floor_map.xpm
WE ./utils/sprite/map/floor_map.xpm
EA ./utils/sprite/map/floor_map.xpm
F 220,255,0
C 225,0,200
1111111111111111111111111
1000000000110000000000001
1000000001110000000000001
1001000000000000000000001
1111111110110000011100001
1000000000110000011101111
1111011111111101110000001
1111011111111101110101001
1100000011010101110000001
1000000000000000110000001
10000000000N0000110101001
1100000111010101111101111
1111011111101011011110101
1111111111111111111111111
