NO ./utils/sprite/game/floor.xpm
SO ./utils/sprite/game/floor.xpm
WE ./utils/sprite/game/floor.xpm
EA ./utils/sprite/game/floor.xpm
F 220,255,0
C 225,0,200
111111111111111111111111
100000000010000100000001
100000000010000100000001
100000000010000100000001
100000000010000100000001
111111111010000100000001
111111111010000100000001
111111111D1111D100000001
100000000000000100000001
100000000000000100000001
100000000000000100000001
100000000000000100000001
100000000000000000000001
100000000000000111111111
100000000000000111111111
111111111111111111111111
