NO ./sprite/textures/north_wall.xpm
SO ./sprite/textures/south_wall.xpm
WE ./sprite/textures/west_wall.xpm
EA ./sprite/textures/north_wall.xpm
F 220,255,0
C 225,0,200
111111111111111111111111
100000001000000100000001
10T000T010T00T0100T00T01
100000001000000100000001
100N00001000000100000001
100000001000000100000001
100000001000000100000001
1000000010000001D1111111
100000001000000101111111
100000001000000101111111
100000001000000D01111111
100000001D11111111111111
100000001011111111111111
100000001011111111111111
10000000D011111111111111
111111111111111111111111
